Tower;ATK ADD;ATK MUL;DEF ADD;DEF MUL;HP ADD;HP MUL;BLUE;CRIMSON;YELLOW
1;4;0;0;0;0;0;0;0;0
1;0;0;4;2;0;0;0;0;0
1;0;0;0;0;0;0;0;0;3
1;0;0;0;0;0;0;0;1;0
1;0;0;0;0;0;0;2;0;0
2;4;0;0;0;0;0;0;0;0
2;0;0;4;0;0;0;0;0;0
2;0;0;0;0;0;0;0;0;3
2;0;0;0;0;0;0;0;1;0
2;0;0;0;0;0;0;2;0;0